111111111111111111111111111111111111111
10000000000011000000110C011000000110C01
1000011110C0000001100001000000110000101
1P001100E010110000111100011000011110C01
111111111111111111111111111111111111111