1111111111111111111111111111111111111111111111111111111
1111111111111111111111111111111111111111111111111111111
1111000000001111001111110011100000000011100111111001111
1111001111111111001111110011100111111111100111000111111
1111001111111111001111110011100111111111100100001111111
1111000000011111001111110011100111111111100001111111101
1111001111111111001111110011100111111111100110001111111
1111001111111111001111110011100111111111100111000011111
1111001111111111000000000011100000000011100111101001111
1111111111111111111111111111111111111111111111111111111
1111110P0000000000000CCCCCC000000000000000E111111111111
1111111111111111111111111111111111111111111111111111111