1111111111111111111111111111111111111111111111111111111111111111111111
1000P1110011C010011EC000010001100000110011C010011EC0000100011000011101
1001100000000110010001011010111001100000000110010001011010000001100001
1000000111010000000000000000000001000000100000000000000000000000000001
1001100000000110010001011010111001100000000110010001011010111001100001
1000000111010100000000000000011001000000100011011000110011111001000001
10011000000001100100010110100C0001100000000110010001011010111001100001
10000001110101000000000000010110000000001000110110001100111110C10E0001
1111111111111111111111111111111111111111111111111111111111111111111111