1111111111111111111111111111111111
1E0000000000000C00000C00000P0000C1
11000000000000000000000000000101C1
10100100101010100010010000000101E1
1000000000000000000000000000000001
1111111111111111111111111111111111